#########
#s  #   #
# k l g #
#   #   #
#########