#########
#   >   #
# s # g #
#   <   #
#########