#########
# s #   #
# b X g #
# x #   #
#########