#########
#   #   #
# g #   #
#   ##l##
#####   #
#   ##l##
# k # t #
#   l s #
#########,
#########
#   #   #
# g #   #
#   #####
#####   #
#   ## ##
# k # t #
#   l   #
#########,
#########
#   l   #
# g #   #
#   ## ##
#####   #
#   #####
# k # t #
#       #
#########,