###########
#         #
#    b    #
#t        #
#   #######
#   #
##l######
#       #
#     t #
#       #
#########,
###########_#########
#   >  t  ###   #   #
#   #bxzy XZY k l k #
#tb #     # #   #   #
#   ###l###l#########
#   #k  #_#l#
#v#^###l#_#g#
#       #_###
#     t #
#       #
#########,
###########_#########
#   #  t  ###   #   #
#   #bxzy XZY k l k #
#tb #     ###   #   #
#   ###X###_#########
#   #k Y#
#v#^###Z#
#     s #
#     t #
#       #
#########
//c1fr1