###########
#gl #    k#
###l#     #
#         #
#l####s   #
# k k#    #
###########
//nighthawk30