#######################
#                     #
#           b  b      #
#      s              #
#                     #
#                t    #
#######################,
#######################
#                     #
#  zyx   v      ><    #
#  ZYX  > <           #
#        ^            #
#                t    #
#######################