###########
#s    #   #
#  b  X g #
#     #   #
## ####   #
_#x########
_###
//c1fr1 & gavith & pasimko