###########
#   y#x   #
#    #t   #
#  #####lY#
#       b #
#     b   #
###########,
###########
#         #
# #x# t   #
#>w <Xb#b #
# #vs#b#  #
#    #g#  #
###########,
###########
# xb      #
#     t   #
#     b   #
#   X     #
#         #
###########
//nighthawk30 - 1:reset 2:controls 3-4:lockpuzzle