#######################
#                     #
#              b      #
#      s              #
#                     #
#                t    #
#######################,
#######################
#                     #
#        v      ><    #
#       > <           #
#        ^            #
#                t    #
#######################