#######
#    t#
#  x  #
#     #
# b   #
#     #
###X###
#     #
#  kb #
#     #
#######,
#######
#    t#
#  s  #
####X##
# b   #
#  x  #
#     #
#     #
#   b #
#     #
#######
