#########
# s #   #
#   X g #
##b##   #
_#x######
_###
//c1fr1 & gavith