##################################
#  t      <>v<v>vv>^<>^>vv>^>v^<t#
#         v^v>#                  #
#  s       >^ #                  #
##################################,
#######
#     #
#     #
#     #
#######,
#######
#     #
#     #
#     #
#######,
#######
#     #
#     #
#     #
#######,
#######
#     #
#     #
#     #
#######,
#######
#     #
#     #
#     #
#######,
#######
#     #
#     #
#     #
#######,
#######
#     #
#     #
#     #
#######,
#######
#     #
#     #
#     #
#######,
#######
#     #
#     #
#     #
#######,
#######
#     #
#     #
#     #
#######,
#######
#     #
#     #
#     #
#######,
#######
#     #
#     #
#     #
#######,
#######
#     #
#     #
#     #
#######,
#######
#     #
#     #
#     #
#######,
#######
#     #
#     #
#     #
#######,
#######
#     #
#     #
#     #
#######,
#######
#     #
#     #
#     #
#######,
#######
#     #
#     #
#     #
#######,
#######
#     #
#     #
#     #
#######,
#######
#     #
#     #
#     #
#######,
#######
#     #
#     #
#     #
#######,
#######
#     #
#     #
#     #
#######,
#######
#     #
#     #
#     #
#######,
#######
#     #
#     #
#     #
#######,
#######
#     #
#     #
#     #
#######,
#######
#     #
#     #
#     #
#######,
#######
#     #
#     #
#     #
#######,
#######
#     #
#     #
#     #
#######,
#######
#     #
#     #
#     #
#######,
#######
#     #
#     #
#     #
#######,
#######
#     #
#  g  #
#     #
#######,
#######
#     #
#     #
#     #
#######,
#######
#     #
#     #
#     #
#######,
#######
#     #
#     #
#     #
#######,
#######
#     #
#     #
#     #
#######,
#######
#     #
#     #
#     #
#######,
#######
#     #
#     #
#     #
#######,

