######
#s   #
#    #
#   g#
######