########
#t   Xg#
# s  ###
#  b   #
#      #
#      #
#      #
########,
########
#t   Xg#
#    ###
#  b   #
########
#      #
#     x#
########
//gavith