###########
#s       y#
#YbZbYbXbZ#
#zzzzzzzzz#
#YXYZXYZXZ#
#ZYXYZXYZX#
#xxxxxxxxx#
#YYZZXXYXZ####
#ZZZZZZZZZ  t#
##############,
###########
#s       y#
#YbZbYbXbZ#
#zzzzzzzzz#
#YXYZXYZXZ#
#ZYXYZXYZX#
#xxxxxxxxx#
#YYZZXXYXZ####
#ZZZZZZZZZ# t#
##############