##################@
#  s      #     t#@
#         #      #@
###### ####      #@
g    #           #@
##################,
##################@
#         #     t#@
#         #      #@
#####   ###      #@
g                #@
###################,