###############
#t   #   #   z#
#        #    #
#s   #####b   #
#    Z        #
###############,
###############
#t           z#
#             #
#    #####bd   #
#    Z   #    #
#########g#####
