######
#s  t#
#b   #
#    #
######,
######
#s  t#
#b   #
##   #
######