##################@
#________________#@
#########________#@
        #____s___#@
        #_______t#@
        ##########,
####@
# ##@
####,
####@
#xx#@
####