############
#    t#    #
#     <    #
#     ######
# b   #
#     #
####Y##
#     #
#  k  #
#     #
#######,
############
# z  t#  t #
#  s  #    #
#####X#    #
# b   #    #
#  xb Z    #
#     ######
#######,
#################
#     #  t #    #
#  y  # z  Z    #
#########Y####l##
# b  k     # g  #
#################
