######
#s  t#
#    #
#    #
######,
######
#   t#
# b  #
#    #
######,
######
#   t#
# b  #
#    #
######