##################
#  s            t#
#                #
###### ####  b   #
g    #           #
##################,
##################
#         #     t#
#         #      #
#####   ###      #
g                #
##################,