#############
#s          #
#t          #
###########l#
#           #
#############,
#############
#          k#
#t          #
#############
#          g#
#############