##################@
#  s      <     t#@
#         >      #@
###### #^v#      #@
g    #           #@
##################,
##################@
#         #     t#@
#         #      #@
#####   ###      #@
g                #@
##################,