##############
#s           #
#            #
#            #
#   ######   #
#v_v#____#^_^#
# _ #____# _ #
# _ #____# _ #
#v_v#____#^_^#
#   ######   #
#            #
#            #
#            #
#            #
##############,
