###___###########
#t#####x##      #
#   #   ##      #
#b XYX bYX      #
#   #  s##      #
#y#####t##      #
###___###########,
###___###########
#t#####y#       #
#   #   #       #
#b  Y  b#       #
#   #   #       #
#x#####t#       #
###___###########,
