##############
#s           #
#            #
#            #
#   ######   #
#v_v#____#^_^#
# _ #____# _ #
# _ #____# _ #
#v_v#____#^_^#
#   ######   #
#    #__#    #
#    #__#    #
#    #__#    #
#t   #__#   t#
##############,
##############
#           t#
#            #
#            #
#   ######   #
#___#____# __#
# _ #____# _ #
# _ #____# __#
#v_v#____#__ #
#   ######   #
#            #
#            #
#            #
#t          t#
##############,