####################
#                  #
#                  #
####################
#                  #
#                  #
#        b         #
#                  #
####################,
####################
#                  #
#                  #
####################
#                  #
#                  #
#        b         #
#                  #
####################,
####################
#                  #
#                  #
####################
#                  #
#                  #
#        b         #
#                  #
####################,