#########
#s #    #
# b #   #
###  #  #
# ##  # #
#  ##  ##
#########,