##################@
#_______________t#@
#########________#@
        #____s___#@
        #________#@
        ##########,
##################@
#_______________t#@
#########_______s#@
        #________#@
        ###______#@
        ##########,
##################@
#_______________t#@
#########_______s#@
        #________#@
        #______###@
        ##########,
##################@
###_____________t#@
#########_______s#@
        #________#@
        #________#@
        ##########