########
#s    t#
###l####
#      #
########,
########
#k    t#
########
#k   lg#
########,