##################
#               t#
#                #
###### #### b    #
g    #           #
#    #           #
#        ##      #
#        ##      #
#                #
#                #
#                #
#                #
##################,
##################
#               t#
#        s       #
###### #### b    #
g    #           #
#    #           #
#        ##      #
#        ##      #
#                #
#                #
#                #
#                #
##################,