###########
#         #
#    b    #
#t        #
#   #######
#   #
##l######
#       #
#     t #
#       #
#########,
###########_#####
#   >  t  ###   #
#   #bxzy XZY k #
#tb #     # #   #
#   ###l###l##l##
#   #k  #_#l#   #
#v#^###l#_#g# k #
#       #_###   #
#     t #___#####
#       #
#########,
###########_#####
#   #  t  ###   #
#   #bxzy XZY k #
#tb #     ###   #
#   ###X###_##l##
#   #k Y#___#   #
#v#^###Z#___# k #
#     s #___#   #
#     t #___#####
#       #
#########
//c1fr1