##################@
#_______________t#@
#########________#@
        #____s___#@
        #________#@
        ##########,
####@
# ##@
####,
####@
#xx#@
####