##############
#s   #__#   t#
#    #__#    #
#    #__#    #
#   ######   #
#v_v#    #^_^#
# _ # ___# _ #
# _ #   b  _ #
#v_v#  __#v_^#
#   ######   #
#    #__#    #
#    #__#    #
#    #__#    #
#t   #__#   t#
##############,
##############
#    #__#   t#
#    #__#    #
#    #__#    #
#   ######   #
#___#____# __#
# _ #x___# _ #
# _ #___b#t__#
#v_v#____#s__ #
#   ######   #
#            #
#            #
#     #X#    #
#t    #g#   t#
##############,