#########
#g  >  s#
#^^##   #
#   <   #
#########
//c1fr1 pasimko