#################
#         #  #  #
#tx  bsb  #  X z#
#         #  #  #
#   ##Z## ## ## #
#   #   #       #
#   # g #########
#########________,
#################
#         #  #  #
#tx  b b  Y  X z#
#         #  #  #
######Z## ## ## #
# y #   #       #
#   # g #########
#########________
//c1fr1