###############
#t   #   #   z#
#        #    ########
#s   #####b   #      #
#    Z        #      #
######  #######      #
_____#               #
_____#################,
###############
#t           z#
#             ########
#    #####b   #      #
#    Z        #      #
######^^#######      #
_____#               #
_____#################,