######
#s   #
#    ###
#t   lg#
########,
######
#s   #
#    ###
#t    k#
########