_______###
_______#z#
_______# #
######## #
#t   #   #
#    b   #
#s   ##############
#    Z           t#
###################,
################
#t  #         z#
#   >b        ########
# ########    #      #
#    Z        #      #
######^^#######      #
_____#               #
_____#################,
################
#t   #   #    z#
#    b   #    ########
#    #####    #      #
#    Z        #      #
######^^#######      #
_____#               #
_____#################,