#######################
#                     #
#        b  b  b b b  #
#      s b  b  b b b  #
#   bbbbbbbb          #
#                t    #
#######################,
#######################
#                     #
#  zyx   v      ><    #
#  ZYX  > <           #
#        ^            #
#                t    #
#######################