#######
#    t#
#     #
#     #
# b   #
#     #
#######
#     #
#  k  #
#     #
#######,
############
# z  t#  g #
#  s  #    #
#####X#    #
# b   #    #
#  xb Z    #
#     ######
#######
