##################@
#________________#@
#########___s____#@
        #________#@
        #________#@
        ##########,
####@
# ##@
####,
####@
#xx#@
####