#######@
#  t  #@
#     #@
#  s  #@
#######,
#######@
#     #@
#     #@
#     #@
#######,
#######@
#     #@
#     #@
#     #@
#######,
#######@
#     #@
#     #@
#     #@
#######,
#######@
#     #@
#     #@
#     #@
#######,
#######@
#     #@
#     #@
#     #@
#######,
#######@
#     #@
#     #@
#     #@
#######,
#######@
#     #@
#     #@
#     #@
#######,
#######@
#     #@
#     #@
#     #@
#######,
#######@
#     #@
#     #@
#     #@
#######,
#######@
#     #@
#     #@
#     #@
#######,
#######@
#     #@
#     #@
#     #@
#######,
#######@
#     #@
#     #@
#     #@
#######,
#######@
#     #@
#     #@
#     #@
#######,
#######@
#     #@
#     #@
#     #@
#######,
#######@
#     #@
#     #@
#     #@
#######,
#######@
#     #@
#     #@
#     #@
#######,
#######@
#     #@
#     #@
#     #@
#######,
#######@
#     #@
#     #@
#     #@
#######,
#######@
#     #@
#     #@
#     #@
#######,
#######@
#     #@
#     #@
#     #@
#######,
#######@
#     #@
#     #@
#     #@
#######,
#######@
#     #@
#     #@
#     #@
#######,
#######@
#     #@
#     #@
#     #@
#######,
#######@
#     #@
#     #@
#     #@
#######,
#######@
#     #@
#     #@
#     #@
#######,
#######@
#     #@
#     #@
#     #@
#######,
#######@
#     #@
#     #@
#     #@
#######,
#######@
#     #@
#     #@
#     #@
#######,
#######@
#     #@
#     #@
#     #@
#######,
#######@
#     #@
#     #@
#     #@
#######,
#######@
#     #@
#  g  #@
#     #@
#######,
#######@
#     #@
#     #@
#     #@
#######,
#######@
#     #@
#     #@
#     #@
#######,
#######@
#     #@
#     #@
#     #@
#######,
#######@
#     #@
#     #@
#     #@
#######,
#######@
#     #@
#     #@
#     #@
#######,
#######@
#     #@
#     #@
#     #@
#######,

