#########
#s  #   #
#   l g #
#k  #   #
#########
//c1fr1 & pasimko