##################@
#         #      #@
#    s    #      #@
#         #   k  #@
###### ####      #@
gl  t     #      #@
##################,
##################@
#         #      #@
#         #      #@
#         #   k  #@
###### ####      #@
gl  t            #@
##################,
##################@
#         #      #@
#         #      #@
#         #   k  #@
###### ####      #@
gl  t            #@
##################