##################@
#_______________t#@
#########________#@
        #____s___#@
        #________#@
        ##########,
##################@
#_______________t#@
#########_______s#@
        #________#@
        #________#@
        ##########,
##################@
#_______________t#@
#########_______s#@
        #________#@
        #________#@
        ##########,
##################@
#_______________t#@
#########_______s#@
        #________#@
        #________#@
        ##########