#######################
#                     #
#              b      #
#      s              #
#                     #
#                t    #
#######################,
#######################
#                     #
#    x   v      ><    #
#       > <           #
#    X   ^            #
#                t    #
#######################