#############
#t  #   #   #
#   l   Y k #
#   #   #   #
#   #vvv##^##
#  s  b     #
#     t     #
######X######
_____#Y#
_____#g#,
#############
#t  #   #   #
# ykl   Y k #
#   #   #   #
#####vvvb##v##
#     b     #
#     t     #
######X######
_____#Y#
_____#g#