##############
#s           #
#            #
#            #
#   ######   #
# _ #____# _ #
# _ #____# _ #
# _ #____# _ #
# _ #____# _ #
#   ######   #
#            #
#            #
#            #
#            #
##############,
