#######################
#                     #
#                     #
#      s              #
#                     #
#                t    #
#######################,
#######################
#                     #
#        v            #
#       > <           #
#        ^            #
#                t    #
#######################