###___##########
#t#####x#      #
#   #   #      #
#b XYX b#      #
#   #  s#      #
#y#####t#      #
###___##########,
###___##########
#t#####y#      #
#   #   #      #
#b  Y  bX      #
#   #   #      #
#x#####t#      #
###___##########,
