#######################@
#                     #@
#                     #@
#      s              #@
#                     #@
#                t    #@
#######################,
#######################@
#                     #@
#        v            #@
#       > <           #@
#        ^            #@
#                t    #@
#######################