##################@
#         #      #@
#    s    #      #@
#         #   k  #@
###### ####      #@
l   t     #      #@
##################,
##################@
#         #      #@
#         #      #@
#         #   k  #@
###### ####      #@
l   t            #@
##################