##################@
#        t#      #@
#    s    #      #@
#        k#      #@
######l####      #@
gl        #      #@
##################,
##################@
#        t#      #@
#         #      #@
#        k#      #@
######l####      #@
gl               #@
##################