##################@
#_______________t#@
#########________#@
        #________#@
        #________#@
        ##########,
##################@
#_______________t#@
##########______s#@
        #________#@
        #________#@
        ##########,
##################@
#_______________t#@
##########_______#@
        #_#______#@
        #________#@
        ##########,
##################@
#_________#_____t#@
#########_#______#@
        #_#______#@
        #________#@
        ##########