##################@
#               t#@
#########        #@
________#        #@
________#        #@
________##########,
##################@
#               t#@
##########       #@
________#        #@
________#        #@
________##########,
##################@
#               t#@
##########       #@
________# #  s   #@
________#        #@
________##########,
##################@
#         #     t#@
######### #      #@
________# #      #@
________#        #@
________##########