#########################@
#<>v<v>vv>^<>^>vv>^>v^<t#@
#v^v>#___________________@
#s>^ #___________________@
#########################,
#######@
#     #@
#     #@
#     #@
#######,
#######@
#     #@
#     #@
#     #@
#######,
#######@
#     #@
#     #@
#     #@
#######,
#######@
#     #@
#     #@
#     #@
#######,
#######@
#     #@
#     #@
#     #@
#######,
#######@
#     #@
#     #@
#     #@
#######,
#######@
#     #@
#     #@
#     #@
#######,
#######@
#     #@
#     #@
#     #@
#######,
#######@
#     #@
#     #@
#     #@
#######,
#######@
#     #@
#     #@
#     #@
#######,
#######@
#     #@
#     #@
#     #@
#######,
#######@
#     #@
#     #@
#     #@
#######,
#######@
#     #@
#     #@
#     #@
#######,
#######@
#     #@
#     #@
#     #@
#######,
#######@
#     #@
#     #@
#     #@
#######,
#######@
#     #@
#     #@
#     #@
#######,
#######@
#     #@
#     #@
#     #@
#######,
#######@
#     #@
#     #@
#     #@
#######,
#######@
#     #@
#     #@
#     #@
#######,
#######@
#     #@
#     #@
#     #@
#######,
#######@
#     #@
#     #@
#     #@
#######,
#######@
#     #@
#     #@
#     #@
#######,
#######@
#     #@
#     #@
#     #@
#######,
#######@
#     #@
#     #@
#     #@
#######,
#######@
#     #@
#     #@
#     #@
#######,
#######@
#     #@
#     #@
#     #@
#######,
#######@
#     #@
#     #@
#     #@
#######,
#######@
#     #@
#     #@
#     #@
#######,
#######@
#     #@
#     #@
#     #@
#######,
#######@
#     #@
#     #@
#     #@
#######,
#######@
#     #@
#  g  #@
#     #@
#######,
#######@
#     #@
#     #@
#     #@
#######,
#######@
#     #@
#     #@
#     #@
#######,
#######@
#     #@
#     #@
#     #@
#######,
#######@
#     #@
#     #@
#     #@
#######,
#######@
#     #@
#     #@
#     #@
#######,
#######@
#     #@
#     #@
#     #@
#######,

