#############
#s          #
#t          #
#####l#######
#       #
#########,
#############
#          k#
#t          #
#############
#      g#
#########
//nighthawk30 & pasimko & c1fr1