###########
##     s ##
#   t     #
# #   b   #
#         #
#    v    #
#   >X<   #
#    ^  b #
#       b #
#         #
###########,
###########
##       ##
#   t    v#
#     b  x#
#         #
#      #v^#
##     #X##
##     #b##
##     #b##
##     #g##
###########