######
#s  t#
# b  #
#    #
######,
######
#   t#
# b  #
##   #
######