##################@
#               t#@
#   s            #@
#________________#@
#                #@
##################,
##################@
#               t#@
#                #@
#__ _____________#@
#                #@
##################