__##################
__#k    #         k#
__#     #t         #
######l###^#######l#
# l <   #          #
#v#######          #
# l l  g#t   s     #
####################,
__##################
__#k    >       # k#
__#     #t      #  #
##########^#######l#
# l <   #          #
#v#######          #
# l l  g#t         #
####################,
__##################
__#             # k#
__#t            #  #
###########^######l#
# l <   #          #
#v#######          #
# l l  g#t         #
####################,
