########
#kZ  #y#
###   l##
#gY     #
###   z #
#  b    #
#     s #
#########
//nighthawk30