######
#s   #
#    #
#  t #
######,
######
#g   #
#    #
#  t #
######