######
#s   #
#t   #
#    #
######,
######
#    #
#t   #
#    #
######,
######
#    #
#t   #
#   t#
######,
######
#    #
#    #
#   t#
######,
######
#    #
#    #
#   t#
######