##################@
#_______________t#@
#########________#@
        #____s___#@
        #________#@
        ##########,
##################@
#_______________t#@
##########______s#@
        #________#@
        #________#@
        ##########,
##################@
#_______________t#@
##########______s#@
        #_#______#@
        #________#@
        ##########,
##################@
#_________#_____t#@
#########_#_____s#@
        #_#______#@
        #________#@
        ##########