#########
#   #   #
# g #   #
#   ##l##
#####   #
#   ##l##
# k # s #
#   l  t#
#########,
#########
#   #   #
# g #   #
#   #####
#####   #
#   ## ##
# k #   #
#   l  t#
#########,
#########
#   l   #
# g #   #
#   ## ##
#####   #
#   #####
# k #   #
#      t#
#########
//c1fr1