#######
#gY   #
### x #
# s   #
#  b  #
#     #
#X#####
# b  y#
#######
//nighthawk30